############################
#--------------------C-----#
#--@-----------------------#
#--------------------------#
#--------------------------#
#--------------------------#
#--------------------------#
#--------------------------#
#--------------------------#
#--------C------------C----#
#--------------------------#
############################