############################
#--------------------C-----#
#--@-----------------------#
#--------------------------#
#--------------------------#
#--------------------------#
#--------------------------#
#--------------------------#####
#------------------------------#
#--------C------------C------T-#
#------------------------------#
################################